.--\     [
]__J     [
]        [
.--\     [
]_ J     [
]        [
.--\     L
]__J      
]        /
.--------,