XXXX]!  L[
XXXX]    [
]_=_!    [
]        [
]        [
]        [
]        L
]         
]        /
.--------,