__________
          
          
          
\  /--\  /
]  [XX]  [
]  [XX]  [
]  L _J  [
]        [
.--------,