]J L__ __[
]        [
]        [
]     /--,
]     [XXX
]     L _[
J        [
         [
\        [
.--------,