]_____ __[
]        [
]        [
]     /--,
]     [XXX
]     L__[
!        [
         [
\        [
.--------,