.--\     [
]__J     [
]        [
.--\     [
]__J     [
]        [
.--\     [
]__J     [
]        [
.--\     [