]________[
]        [
.--\  /--,
]__J  L_ [
]        [
.--\  /--,
]__J  L___
]         
]        /
.\ /-----,